...###......
..##.#.####.
.##..###..#.
##........^.
#...@..#..#.
##%..%##..#.
..#..#....#.
.##.##.#.##.
.#......##..
.#######....